0000000000
0000333300
0004400300
4400333300
0000000300
0000333300
0000000000
0440000000
0000000000
0000000000