0000000000
0002222000
0000000200
0440002000
0000200000
0020000000
0002222200
0000440000
0000000000
0000000000