0000000000
0000000000
0022222000
0020000444
0022220000
4440002000
0022222000
0000000000
0000000000
0000000000