0000000000
0000011000
0000101044
0000001000
0000001000
0000001000
0044411100
0000000000
0000000000
0000000000