0000000000
0000000000
0001111100
0000001000
0000100000
4401000044
0001000000
0000000000
0000000000
0000000000