0000000000
0001111100
0001000100
4440011000
0044440100
0000111100
0000000000
0000000000
0000000000
0000000000