0000000000
0000000000
0002220444
0020002000
4441110000
0020000200
0002220000
0000000000
0000000000
0000000000