0000000000
0000000000
0010000100
0010000100
0011111100
0000000100
0044400100
0000000000
0000000000
0000000000