0000000000
0004444000
0003330000
0030000000
0033330000
0030003000
0003330000
0004444000
0000000000
0000000000